NO OUI
SO ./assets/brick_wall.xpm
WE ./assets/brick_wall.xpm
EA ./assets/brick_wall.xpm
F NON
C 225,30,0

        1111111111111111111111111
        1000000000110000000000001
        1011000001110000000000001
        1001000000000000000000001
111111111011000001110000000000011
100000000011000001110111111111111
11110111111111011100000010001
11110111111111011101010010001
11000000110101011100000010001
1000000000000000110000001S001
10000000000000001101010000001                 
11000001110101011111010000001      
11110111 1110101 101111010001
11111111 1111111 111111111111
