NO ./assets/backroom_wall.xpm
SO ./assets/backroom_wall.xpm
WE ./assets/backroom_wall.xpm
EA ./assets/backroom_wall.xpm
F 118, 101, 56
C 30, 20, 20

111111111111111111111111111111111
100000000000000000110000000000001
100000000000000001110000000000001
100000000000000000000000000000001
100000000000000001110000000000011
100000000000000001110111111111111
10000000000000000001110000001
11110111111111011101010010001
11000000110101000000000010001
1000000000000000110000001S001
10000000000000001101010000001
11000001110101011111010000001
11110111 1110101 101111010001
11111111 1111111 111111111111
