NO ./assets/backroom_wall.xpm
SO ./assets/backroom_wall.xpm
WE ./assets/backroom_wall.xpm
EA ./assets/backroom_wall.xpm
F 118, 101, 56
C 30, 20, 20

11111111111111111
1000D0000000D0001
11D11111D11D11D11
1000D0000000D0001
11D11111D11D11D11
1000D0000000D0001
11D11111D11D11D11
10000000000000001
1000000N000000001
11111111111111111